NO textures/brick2.xpm
SO textures/brick2.xpm
WE textures/brick2.xpm
EA textures/brick2.xpm

F 184,113,39
C 51,54,227


111111111 1111
1000000W1 1001
111111111 1111
