NO textures/mossy.xpm
SO textures/purplestone.xpm
WE textures/brick.xpm
EA textures/brick.xpm

F 45,113,39
C 51,198,190

         111111111  111111111111111111
         100000001  1S0000000000000001
         10110000111100000001111111111
11111111110000000000000000011111
10000000111100010000000001001
100000001  100110101110000001
10000000111110000001 10100001
11111111111111111111 11111111
     
1111 111111111111111111111111
1111 100000000000000000000001
1111 111111111111111111111111
